11111111111111111111
11111111111111111111
00000000000000000000
00000000000000000000
11111111111111111111
00001111000111100011
11110000111000011100