10111011
10111011
00101000
00001100
01011001
01100011
00011100